111111111111111
1V00V1ECV00V0C1
100000000010001
10V010000000001
100000000000001
10000000C000001
1C00000C00010V1
100000P00000001
111111111111111